w w w w w w w w w w w w w w w w w w w w w w w w m m w w w m w w w m m m w w w w w w w w w w w w w w w w w w w w w w w w w
w w w w w w w w w w w w w w w w w w w w w m m m g g m m m g m m m g g g m m w w m m w w w w w w w w w w w w w w w w w w w
w w w w w w w w w w w w w w w w w w w m m g g g g g g g g g g g g g g g g g m m g g m m w w w w w w w w w w w w w w w w w
w w w w w w w w w w w w w w w w w m m g g g g g g g g g g g g g g g g g g g g g g g g m m w w w w w w w w w w w w w w w w
w w w w w w w w w w w w w w w w m g g g g g g g g g g g g g g g g g g g g g g g g g g g g m w w w w w w w w w w w w w w w
w w w w w w w w w w w w w w w m g g g g g g g g g g g g g g g g g g g g g g g g g g g g g g m w w w w w w w w w w w w w w
w w w w w w w w w w w w w w m g g g g g g g g g g g g g g g g g g g g g g g g g g g g g g g m w w w w w w w w w w w w w w
w w w w w w w w w w w w w m g g g g g g g g g g g g g g g g g g g g g g g g g g g g g g g g g m w w w w w w w w w w w w w
w w w w w w w w w w w w m g g g g g g g g g g g g g g g g g g g g g g g g g g g g g g g g g g m m w w w w w w w w w w w w
w w w w w w w w w w w m g g g g g g g g g g g g g g g g g g g g g g g g g g g g g g g g g g g g m w w w w w w w w w w w w
w w w w w w w w w w w m g g g g g g g g g g g g g g g g g g g g g g g g g g g g g g g g g g g g m w w w w w w w w w w w w
w w w w w w w w w w w w m g g g g g g g g g g g g g g g g g g g g g g g g g g g g g g g g g g m w w w w w w w w w w w w w
w w w w w w w w w w w w m g g g g g g g g g g g g g g g g g g g g g g g g g g g g g g g g g m w w w w w w w w w w w w w w
w w w w w w w w w w w w w m g g g g g g g g g g g g g g g g g g g g g g g g g g g g g g g m w w w w w w w w w w w w w w w
w w w w w w w w w w w w w m g g g g g g g g g g g g g g g g g g g g g g g g g g g g g g g m w w w w w w w w w w w w w w w
w w w w w w w w w w w w w w m g g g g g g g g g g g g g g g g g g g g g g g g g g g g g m w w w w w w w w w w w w w w w w
w w w w w w w w w w w w w w w m g g g g g g g g g g g g g g g g g g g g g g g g g g g m w w w w w w w w w w w w w w w w w
w w w w w w w w w w w w w w w w m g g g g g g g g g g g g g g m g g m m g g g g g m m w w w w w w w w w w w w w w w w w w
w w w w w w w w w w w w w w w w w m m m g g g g g m m g g m m w m m w w m g g m m w w w w w w w w w w w w w w w w w w w w
w w w w w w w w w w w w w w w w w w w w m m m m m w w m m w w w w w w w w m m w w w w w w w w w w w w w w w w w w w w w w